..0000000000000
....B........B0
0.......B0....0
000000000.B..00
0....B.......B0
0.........00000
0....0000000B00
0......B......0
00000....00...0
0000000000B..00
000..........00
000...000000000
00B........B000
0000000B......0
000000000000...
