..0000000000000
....1........10
0.......10....0
000000000....00
0....1.......10
0.........00000
0....0000000100
0......1......0
00000....00...0
00000000001..00
000..........00
000...000000000
001........1000
00000001......0
000000000000...
