--0000000000000
--............0
0........0....0
000000000....00
0.............0
0.........00000
0....0000000.00
0.............0
00..0....00...0
00...00000...00
000..........00
000...000000000
00..........000
0000000.....--0
0000000000000--
