..0000000000000
..............0
0.............0
0.............0
0....B.......B0
0.........00000
0............00
0......B......0
00000.........0
0000.........00
000..........00
000.......00000
00B........B000
0000000B......0
000000000000...
