..0000000000000
.............00
00...B000B....0
0...0000000...0
0..B0000000B..0
0..000000000..0
0...B00000B...0
0....00B00....0
00...........00
000..0B...0B000
0000....0000000
0000B..00000000
000000...B00000
0000000.......0
000000000000...
