--0000000000000
--............0
0.............0
0.............0
0.............0
0.........00000
0............00
0.............0
00000.........0
0000.........00
000..........00
000.......00000
00..........000
0000000......-0
000000000000---
